11111111111111111
1C10C10C010000C11
1G000G00000G10001
10100000111111101
1P1000G000GC001E1
11111111111111111