11111111111111111
1C10C10C010000C11
10000G00000G10001
10100000111111101
1P10G0G000C0010E1
11111111111111111