11111111111111111111
1P0000C0EG0000G000G1
11111111111111111111