11111111
1000G0C1
11110111
1P0000E1
11111111