11111111111111111
1E10010001000G011
100000G0000010001
1C100000111111101
1P1000G000G0001G1
11111111111111111